000000000000000
011100000000000
010100000000000
110100000000000
000111111111000
000000000001000
001111111001000
001000001101000
001000000101000
001000111101000
001000100001000
001000100001000
001000000001000
001111111111000
000000000000000