000000000000
011100000000
010100000000
110100000000
000111111111
000000000000
000000000000
000000000000
000000000000
000000000000
000000000000