00000000000000000
01110000011111111
01010000010000000
11010000010000000
00011111110000000
00000000000000000