000000200000000
011100202222000
010100222002220
110100000000020
000111111111020
000000000001020
001111111001020
001000001101020
001000000101020
001000111101020
001000100001020
001000B22223220
001000000001000
001111111111000
000000000000000